SOF1
163 168 168 143 168 168 168 168 168 168 168
160 160 160 160 160 160 160 160 160 160 168
168 168 168 156 168 160 168 143 168 160 168
143 168 168 160 168 160 168 143 168 160 168
160 156 160 160 168 160 160 160 168 160 168
143 168 168 160 168 156 168 168 168 160 168
168 168 144 160 168 160 160 160 160 160 168
160 156 160 160 168 168 66 168 168 168 168
168 168 168 160 160 168 160 160 160 156 160
168 168 143 160 168 168 168 160 143 168 144
168 168 143 160 168 168 168 160 143 143 143
EOF1